11111111
1P000001
10000C01
10E00001
11111111