11111111
1P0P0001
10000C01
10E00001
10000001
10000001
111111111