11111
100P1
100C1
1E001
11111
