111111
1P0001
1000E1
1C0001
111111
