111111
1P0001
10M0E1
1C0001
111111
