111111111111111
1111111E1111111
111111101111111
111111101111111
111111101111111
11M111101111111
11111100M111111
111111101111111
111111M00111111
111111101111111
11110000M111111
111101101111M11
111101C00111111
111101111111111
111100M0C111111
111110001111111
111111MCM111111
111111101111111
1111111P1111111
111111111111111
