1111111111111111
10M0000C000000E1
1111110000011111
1000001110000111
1000C00000000001
10M0011111100P01
1111111111111111