1111111111111
10001C0001111
100C100000111
1011000110011
100001111P001
1000000E111C1
1111111111111