111111111111111111111111111111111111111111111111
100000001111111000000000011100000000000E11111111
101111101111100011111111011001111111111111111111
101100000011101001111111011001100000000001111111
101101111000001100000000011001101111111000111111
101100011011111101111111000000000011111000000111
101111C11000000000000011011111101011111000110111
101111111111000000000011011111101011111000110111
100000000000000000000011C11111100011111000110111
111111111111000000000000111111111111111000100111
1111111111111111111111001111111111111C1000101111
111100000000000000000000111111111111101111101111
111001111110111111111100111111111111101111101111
110011C10000111111111100111111111111101101101111
110111011111111111111100111111111111100001101111
110100011111111111111110000000111111101111101111
110001011111111111111111111110111111100001111111
111111C11000000000000000000000111111101101111111
111111111011111111111111111110111111101101111111
11111C000011111111111111111110000000000000011111
111111100011111111111111111111111111111111011111
100000000000000000000000C00000000000000000000001
11111110P000000000000000000000000000000111111111
111111111111111111111111111111111111111111111111