11111111111
1C000000001
11000000001
1P00C000E01
11111111111