111111111111111111111111111111111
1000000000000000000000000000000E1
101111111111111111111111111111111
100000000000000000000000000000001
11111111111111C011111111111111111
100000000000000000000000000000001
100001111111111111111111111111111
10M00000000000000000000C000000001
111111111111111111111111111100001
10C000000000000000000000000000001
1000000000000M0000000000000000001
100000M0000000000000C000000000001
100000000000000000000000000000001
1000000000000C0000000000000000001
1000000000M0000000000000000M00001
1P0000000000000000000000000000001
111111111111111111111111111111111