11111111111
1C000001E01
11000000011
11111111111
1P000000001
11111111111