11111111111
10000001E01
100000C0111
11110000001
1P000000001
11111111111