111111111
100000001
100000111
1P0C001E1
111111111