11111111111111111111111111
11111111E111110C0100000111
11111111010001010101110111
11111111010M0M0M0M0M100M11
111111110001010101011MC011
1111111111110C010C01100M11
11111111111111111111110111
11100000000111100000000111
1110111110000M101111110111
11101111100000001111M101M1
111C1111111111101111110111
111M100000001M00M111110111
11000000000000000C0M110111
11011111111111111111110111
1100M111111110000000000111
11101111111M1MC0C0C0CM1M11
111P1111111M10000000001M11
11111111111111111111111111
