1111111111111111
11M0000C00000E11
1111110000011111
1100001110000111
1100C00000000011
11M0011111100P11
1111111111111111